1 1 1 1 1 1 1 1 1 1 1
1 6 2 2 2 2 2 2 2 7 1
1 2 1 1 1 2 1 1 1 2 1
1 2 1 2 2 0 2 2 1 2 1
1 2 1 2 1 0 1 2 1 2 1
1 2 2 0 0 5 0 0 2 2 1
1 2 1 2 1 0 1 2 1 2 1
1 2 1 2 2 0 2 2 1 2 1
1 2 1 1 1 2 1 1 1 2 1
1 8 2 2 2 2 2 2 2 9 1
1 1 1 1 1 1 1 1 1 1 1
