1 1 1 1 1 1 1 1 1 1 1 1 1 1 1 1 1 1 1 1 1 1 1 1 1
1 0 0 0 0 0 0 0 0 1 0 1 2 1 0 2 2 2 2 2 2 2 2 2 1
1 0 1 1 1 1 1 1 1 1 0 1 2 1 0 1 1 1 1 1 1 1 1 2 1
1 0 1 2 2 2 2 2 2 2 0 1 2 1 0 1 0 0 0 0 0 0 1 2 1
1 0 1 2 1 1 1 1 1 1 0 1 2 1 0 1 1 1 1 1 1 0 1 2 1
1 0 1 2 1 0 0 0 0 1 0 1 2 1 0 2 2 2 2 2 1 0 1 2 1
1 0 1 2 1 0 1 1 1 1 0 1 2 1 0 1 1 1 1 2 1 0 1 2 1
1 0 1 2 1 0 1 9 0 0 0 0 0 0 0 0 0 9 1 2 1 0 1 2 1
1 0 1 2 1 0 1 0 1 1 0 1 1 1 0 1 1 0 1 2 1 0 1 2 1
1 1 1 2 1 1 1 0 1 1 0 1 1 1 0 1 1 0 1 2 1 1 1 2 1
1 0 0 0 0 0 0 0 0 0 0 0 0 0 0 0 0 0 0 0 0 0 0 0 1
1 1 1 1 1 1 1 0 1 1 0 1 1 1 0 1 1 0 1 1 1 1 1 1 1
1 2 2 2 2 2 2 0 1 1 0 1 5 1 0 1 1 0 2 2 2 2 2 2 1
1 1 1 1 1 1 1 0 1 1 0 1 0 1 0 1 1 0 1 1 1 1 1 1 1
1 0 0 0 0 0 0 0 0 0 0 0 0 0 0 0 0 0 0 0 0 0 0 0 1
1 2 1 1 1 2 1 0 1 1 0 1 1 1 0 1 1 0 1 1 1 2 1 1 1
1 2 1 0 1 2 1 0 1 1 0 1 1 1 0 1 1 0 1 0 1 2 1 0 1
1 2 1 0 1 2 1 9 0 0 0 0 0 0 0 0 0 9 1 0 1 2 1 0 1
1 2 1 0 1 2 1 1 1 1 0 1 2 1 0 1 1 1 1 0 1 2 1 0 1
1 2 1 0 1 2 2 2 2 2 0 1 2 1 0 1 0 0 0 0 1 2 1 0 1
1 2 1 0 1 1 1 1 1 1 0 1 2 1 0 1 1 1 1 1 1 2 1 0 1
1 2 1 0 0 0 0 0 0 1 0 1 2 1 0 2 2 2 2 2 2 2 1 0 1
1 2 1 1 1 1 1 1 1 1 0 1 2 1 0 1 1 1 1 1 1 1 1 0 1
1 2 2 2 2 2 2 2 2 2 0 1 2 1 0 1 0 0 0 0 0 0 0 0 1
1 1 1 1 1 1 1 1 1 1 1 1 1 1 1 1 1 1 1 1 1 1 1 1 1
