1 1 1 1 1 1 1 1 1 1 1 1 1 1 1
1 2 2 2 2 2 2 2 2 2 2 2 2 2 1
1 2 1 2 1 1 1 2 1 1 1 2 1 2 1
1 2 1 2 1 2 1 2 1 2 1 2 1 2 1
1 2 1 2 1 2 1 2 1 2 1 2 1 2 1
1 2 1 2 1 2 1 2 1 2 1 2 1 2 1
1 2 1 2 1 2 1 2 1 2 1 2 1 2 1
1 2 1 2 1 2 1 2 1 2 1 2 1 2 1
1 2 1 1 1 2 1 2 1 2 1 1 1 2 1
1 2 0 8 0 0 0 0 0 0 0 9 0 2 1
1 2 1 1 1 1 1 0 1 1 1 1 1 2 1
1 2 2 2 2 2 1 0 1 2 2 2 2 2 1
1 2 1 1 1 1 1 0 1 1 1 1 1 2 1
1 6 0 0 0 0 0 5 0 0 0 0 0 7 1
1 1 1 1 1 1 1 1 1 1 1 1 1 1 1